30
15
14 15 0 0 0 0 1 0 0 0 0 0 0 0 0 0 0 0 0 0 0 0 0 0 0 0 0 0 16 14
14 15 0 0 0 1 1 1 0 0 0 0 0 0 0 0 0 0 0 0 0 0 0 0 0 0 1 0 16 14
14 15 0 0 1 1 1 1 1 0 0 0 0 0 0 0 0 0 0 0 0 0 0 0 0 1 1 1 16 14
14 15 0 0 0 0 35 0 0 0 0 0 0 0 0 0 0 0 0 0 0 0 0 0 0 0 35 0 16 14
14 15 0 0 0 0 35 0 0 0 0 0 0 0 0 0 0 0 0 0 0 0 0 0 0 0 35 0 16 14
14 15 0 0 0 0 35 0 0 0 0 0 0 0 0 0 0 0 0 0 0 0 0 0 0 0 35 0 16 14
14 15 0 0 38 40 35 37 0 0 0 41 0 0 0 0 0 0 0 0 0 0 0 0 0 0 35 0 16 14
14 13 13 13 13 13 13 13 13 13 13 13 0 38 0 0 0 0 0 0 0 0 0 0 0 0 35 0 16 14
14 14 14 14 14 14 14 14 14 14 14 14 13 13 13 0 38 39 0 0 0 0 0 0 0 0 35 40 16 14
14 14 14 14 14 14 14 14 14 14 14 14 14 14 14 13 13 13 0 0 0 0 0 0 0 13 13 13 13 14
14 14 14 14 14 14 14 14 14 14 14 14 14 14 14 14 14 14 33 33 33 33 33 33 33 14 14 14 14 14
14 14 14 14 14 14 14 14 14 14 14 14 14 14 14 14 14 14 33 33 33 33 33 33 33 33 33 33 33 14
14 14 14 14 14 14 14 14 14 14 14 14 14 14 14 14 14 14 33 33 33 33 33 33 33 33 33 33 33 14
14 14 14 14 14 14 14 14 14 14 14 14 14 14 14 14 14 14 33 33 33 33 33 33 33 33 33 33 33 14
14 14 14 14 14 14 14 14 14 14 14 14 14 14 14 14 14 14 14 14 14 14 14 14 14 14 14 14 14 14
_
1
2 : 864 384 1
6 : 64 128
16 : 320 160
-
15
60
14 14 14 14 14 14 14 14 14 14 14 14 14 14 14
14 33 33 33 33 14 33 33 33 33 33 33 33 33 14
14 33 33 33 33 14 33 33 33 33 33 33 33 33 14
14 33 33 33 33 14 33 33 14 14 14 14 33 33 14
14 33 33 33 33 14 33 33 14 14 14 14 33 33 14
14 33 33 33 33 14 33 33 14 14 14 14 33 33 14
14 33 33 33 33 14 33 33 33 33 33 14 33 33 14
14 33 33 33 33 14 33 33 33 33 33 14 33 33 14
14 33 33 33 33 14 14 14 14 33 33 14 33 33 14
14 33 33 33 33 33 33 33 33 33 33 14 33 33 14
14 33 33 33 33 33 33 33 33 33 33 14 33 33 14
14 14 14 14 14 14 14 14 14 14 14 14 33 33 14
14 33 33 33 33 33 33 33 33 33 33 33 33 33 14
14 33 33 33 33 33 33 33 33 33 33 33 33 33 14
14 33 33 33 33 33 33 33 33 33 33 33 33 33 14
14 33 33 33 33 33 33 33 33 33 33 33 33 33 14
14 33 33 14 14 14 14 14 14 14 14 14 14 14 14
14 33 33 33 33 33 33 33 33 33 33 33 33 33 14
14 33 33 33 33 33 33 33 33 33 33 33 33 33 14
14 33 33 33 33 33 33 33 33 33 33 33 33 33 14
14 14 14 14 14 14 0 0 14 0 0 14 0 0 14
14 33 33 33 33 14 0 0 14 0 0 14 0 0 14
14 33 33 33 33 14 0 0 14 0 0 14 0 0 14
14 33 33 33 33 14 0 0 14 0 0 14 0 0 14
14 33 33 33 33 14 0 0 14 0 0 14 0 0 14
14 33 33 33 33 14 0 0 14 0 0 14 0 0 14
14 33 33 33 33 14 0 0 14 0 0 14 0 0 14
14 33 33 33 33 14 0 0 14 0 0 14 0 0 14
14 33 33 33 33 33 33 33 33 33 33 14 33 33 14
14 33 33 33 33 33 33 33 33 33 33 14 33 33 14
14 33 33 33 33 33 33 33 33 33 33 14 33 33 14
14 33 33 33 14 14 14 14 14 14 14 14 33 33 14
14 33 33 33 33 33 33 33 33 33 33 33 33 33 14
14 33 33 33 33 33 33 33 33 33 33 33 33 33 14
42 33 33 33 33 33 33 33 33 33 33 33 33 33 42
42 33 33 33 33 33 33 33 33 33 33 33 33 33 42
42 33 33 33 33 33 33 33 33 33 33 33 33 33 42
42 33 33 33 33 33 33 42 42 42 42 42 42 42 42
42 33 33 33 33 33 33 42 42 43 44 45 42 42 42
42 33 33 33 33 33 33 42 42 42 42 42 42 42 42
42 33 33 33 33 33 33 33 33 33 33 33 33 33 42
42 33 33 33 33 33 33 33 33 33 33 33 33 33 42
42 33 33 33 33 33 33 33 33 33 33 33 33 33 42
42 33 33 33 33 33 33 33 33 33 33 33 33 33 42
42 33 33 33 33 33 33 33 33 33 33 33 33 33 42
42 33 33 33 33 33 33 33 33 33 33 33 33 33 42
42 33 33 33 33 33 33 33 33 33 33 33 33 33 42
42 33 33 33 33 33 33 33 33 33 33 33 33 33 42
42 33 33 33 33 33 33 33 33 33 33 33 33 33 42
42 33 33 33 33 33 33 33 33 33 33 33 33 33 42
42 33 33 33 42 42 42 42 42 42 42 42 42 42 42
42 33 33 33 42 0 0 0 0 0 0 0 0 0 42
42 33 33 33 42 0 0 0 0 0 0 0 0 0 42
42 33 33 33 42 0 0 0 0 0 0 0 0 0 42
42 33 33 33 42 0 0 0 0 0 0 0 0 0 42
42 33 33 33 42 42 42 42 42 42 0 0 0 0 42
42 33 33 33 33 33 33 33 33 33 33 33 33 33 42
42 33 33 33 33 33 33 33 33 33 33 33 33 33 42
42 33 33 33 33 33 33 33 33 33 33 33 33 33 42
42 42 42 42 42 42 42 42 42 42 42 42 42 42 42
_
2
6 : 64 64
2 : 192 1696 2
17 : 288 928
17 : 64 1216
17 : 96 1664
17 : 288 1856
-
100
25
42 42 42 42 42 42 42 42 42 42 42 42 42 42 42 42 48 46 46 46 46 46 46 46 49 42 42 42 42 42 0 0 0 0 0 0 48 46 49 48 46 46 46 46 46 46 46 46 46 46 46 46 46 46 46 49 48 46 46 46 46 46 46 46 46 46 46 46 46 46 46 46 46 46 46 46 46 46 46 46 46 46 46 46 46 46 46 46 46 46 46 46 46 46 46 46 46 46 46 46
42 42 42 42 42 42 42 42 42 42 42 42 42 42 42 42 47 42 42 42 42 42 42 42 47 42 42 42 42 42 0 0 0 0 0 0 50 49 47 50 46 46 46 46 46 46 46 46 46 46 46 46 46 46 49 50 51 0 0 0 0 0 0 0 0 0 0 0 0 0 0 0 0 0 0 0 0 0 0 0 0 0 0 0 0 0 0 0 0 0 0 0 0 0 0 0 0 0 0 42
42 42 42 42 42 42 42 42 42 42 48 46 46 46 46 46 46 46 46 46 46 46 46 46 46 46 46 46 46 46 46 46 46 46 46 46 49 47 47 48 46 46 46 46 46 46 46 46 46 46 46 46 46 46 51 0 0 0 0 0 0 0 0 0 0 0 0 0 0 0 0 0 0 0 0 0 0 0 0 0 0 0 0 0 0 0 0 0 0 0 0 0 0 0 0 0 0 0 0 42
42 42 42 42 42 42 42 42 42 42 47 42 42 42 42 42 42 42 42 42 42 42 42 42 42 42 42 42 42 42 0 0 0 0 0 0 50 51 50 51 0 0 0 0 0 0 0 0 0 0 0 0 0 0 0 0 0 0 0 0 0 0 0 0 0 0 0 0 0 0 0 0 0 0 0 0 0 0 0 0 0 0 0 0 0 0 0 0 0 0 0 0 0 0 0 0 0 0 0 42
42 42 42 42 42 42 42 42 42 42 47 42 42 42 42 42 42 42 42 42 42 42 42 42 42 42 42 42 42 42 0 0 0 0 0 0 0 0 0 0 0 0 0 0 0 0 0 0 0 0 0 0 0 0 0 0 0 0 0 0 0 0 0 0 0 0 0 0 0 0 0 0 0 0 0 0 0 0 0 0 0 0 0 0 0 0 0 0 0 0 0 0 0 0 0 0 0 0 0 42
42 0 0 0 0 0 0 0 0 0 47 0 0 0 0 0 0 0 0 0 0 0 0 0 0 0 42 42 42 42 0 0 0 0 0 0 0 0 0 0 0 0 0 0 0 0 0 0 0 0 0 0 0 0 0 0 0 0 0 0 0 0 0 0 0 0 0 0 0 0 0 0 0 0 0 0 0 0 0 0 0 0 0 0 0 0 0 0 0 0 0 0 0 0 0 0 0 0 0 42
42 0 0 0 0 0 0 0 0 0 47 0 0 0 0 0 0 0 0 0 0 0 0 0 0 0 42 42 42 42 0 0 0 0 0 0 0 0 0 0 0 0 0 0 0 0 0 0 0 0 0 0 0 0 0 0 0 0 0 0 0 0 0 0 0 0 0 0 0 0 0 0 0 0 0 0 0 0 0 0 0 0 0 0 0 0 0 0 0 0 0 0 0 0 0 0 0 0 0 42
42 0 0 0 0 0 0 0 0 0 47 0 0 0 0 0 0 0 0 0 0 0 0 0 0 0 42 42 42 42 0 0 0 0 0 0 0 0 0 0 0 0 0 0 0 0 0 0 0 0 0 0 0 0 0 0 0 0 0 0 0 0 0 0 0 0 0 0 0 0 0 0 0 0 0 0 0 0 0 0 0 0 0 0 0 0 0 0 0 0 0 0 0 0 0 0 0 0 0 42
42 0 0 0 0 0 0 0 0 0 47 0 0 0 0 0 0 0 0 0 42 42 0 0 0 0 42 42 42 42 0 0 0 0 0 0 0 0 0 0 0 0 0 0 0 0 0 0 0 0 0 0 0 0 0 0 0 0 0 0 0 0 0 0 0 0 0 52 0 0 0 52 0 0 0 0 52 0 0 0 0 0 0 0 0 0 0 0 0 0 0 0 0 0 0 0 0 0 0 42
42 0 0 0 0 0 0 0 0 0 47 0 0 0 0 0 0 0 0 0 42 42 34 34 34 34 42 42 42 42 0 0 0 0 0 0 0 0 0 0 0 0 0 0 0 0 0 0 0 0 0 0 0 0 52 0 0 0 42 0 0 0 42 0 0 0 42 42 53 53 53 42 53 53 42 42 42 0 0 42 0 0 42 0 0 0 0 42 0 0 0 0 42 0 0 0 0 42 42 42
42 0 0 0 0 0 0 0 0 0 47 0 0 0 0 0 0 0 0 0 42 42 34 34 34 34 42 42 42 42 0 0 0 0 0 0 0 0 0 0 0 0 0 0 0 0 0 0 0 0 0 0 42 42 42 0 0 0 0 0 0 0 42 0 0 0 42 42 53 53 53 42 53 53 42 42 42 0 0 42 0 0 42 0 0 0 0 42 0 0 0 0 42 0 0 0 0 42 48 46
42 0 0 0 0 0 0 0 0 0 47 0 0 0 0 0 0 0 0 0 42 42 34 34 34 34 42 42 42 42 0 0 0 0 0 0 0 0 0 0 0 0 0 0 0 0 0 0 0 0 0 0 42 42 42 0 0 0 0 0 0 0 42 0 0 0 42 42 42 42 42 42 42 42 42 42 42 53 53 53 53 53 53 53 53 53 53 53 53 53 53 53 53 53 53 53 53 42 47 42
42 0 0 0 0 0 0 0 0 0 47 42 42 42 42 42 42 0 0 0 42 42 34 34 34 34 42 42 42 42 0 0 0 0 0 0 0 0 0 0 0 0 0 0 0 0 0 0 0 42 0 0 42 42 42 0 0 0 0 0 0 0 42 0 0 0 42 42 42 42 42 42 42 42 42 42 42 53 53 53 53 53 53 53 53 53 53 53 53 53 53 53 53 53 53 53 53 42 47 42
42 0 0 0 0 0 0 0 0 0 47 0 0 0 0 0 0 0 0 0 42 42 34 34 34 34 42 42 42 42 0 0 0 0 0 0 0 0 0 0 0 0 0 0 0 0 42 0 0 0 0 0 42 42 42 0 0 0 0 0 0 0 42 0 0 0 42 42 42 42 42 42 42 42 42 42 42 42 42 42 42 42 42 42 42 42 42 42 42 42 42 42 42 42 42 42 42 42 47 42
42 0 0 48 46 46 46 46 46 46 51 0 0 0 0 0 0 0 0 0 42 42 34 34 34 34 42 42 42 42 0 0 0 0 0 0 0 0 0 0 52 0 0 42 0 0 0 0 0 0 0 0 42 42 42 0 0 0 0 0 0 0 42 0 0 0 42 42 42 42 42 42 42 42 42 42 42 42 42 42 42 42 42 42 42 42 42 42 42 42 42 42 42 42 42 42 42 42 47 42
42 0 0 47 0 0 0 0 0 0 0 0 0 0 0 0 0 0 0 42 42 42 34 34 34 34 42 42 42 42 0 0 0 0 0 0 0 42 42 42 42 53 53 53 53 53 53 53 53 53 53 53 42 42 42 53 53 53 53 53 53 53 42 0 0 0 42 42 42 42 42 42 42 42 42 42 42 42 42 42 42 42 42 42 42 42 42 42 42 42 42 42 42 42 42 42 42 42 47 42
42 0 0 0 0 0 0 0 0 0 0 0 0 0 0 0 0 0 42 42 42 42 34 34 34 34 42 42 42 42 0 0 0 0 0 0 42 42 42 42 42 53 53 53 53 53 53 53 53 53 53 53 42 42 42 53 53 53 53 53 53 53 42 0 0 42 42 42 42 42 42 42 42 42 42 42 42 42 42 42 42 42 42 42 42 42 42 42 42 42 42 42 42 42 42 42 42 42 47 42
42 0 0 0 0 0 0 42 42 42 42 42 42 42 42 42 42 42 42 42 42 42 34 34 34 34 42 42 42 42 0 0 0 0 0 42 42 42 42 42 42 42 42 42 42 42 42 42 42 42 42 42 42 42 42 42 42 42 42 42 42 42 42 0 0 0 42 42 42 42 42 42 42 42 42 48 46 46 46 46 46 46 46 46 46 46 46 46 46 46 46 46 46 46 46 46 46 46 51 42
42 42 42 47 42 42 42 42 42 42 48 46 46 46 46 46 46 49 42 42 42 42 34 34 34 34 42 42 42 42 0 0 0 0 42 42 42 42 42 42 42 42 42 42 42 42 42 42 42 42 42 42 42 42 42 42 42 42 42 42 42 42 42 0 0 0 42 42 42 42 42 42 42 42 42 47 42 42 42 42 42 42 42 42 42 42 42 42 42 42 42 42 42 42 42 42 42 42 42 42
42 42 42 47 42 42 42 43 44 45 47 42 42 42 42 42 42 47 42 42 42 42 34 34 34 34 42 42 42 42 0 0 0 42 42 42 42 42 42 42 42 42 42 42 42 42 42 42 42 42 42 42 42 42 42 42 42 42 42 42 42 42 0 0 0 0 42 42 42 42 42 42 42 42 42 47 42 42 42 42 42 42 42 42 42 42 42 42 42 42 42 42 42 42 42 42 42 42 42 42
42 42 42 47 42 42 42 42 42 42 47 42 42 42 42 42 42 47 42 42 42 42 34 34 34 34 34 34 34 34 34 34 34 42 42 42 42 42 42 42 42 42 42 42 42 42 42 42 42 42 42 42 42 42 42 42 42 42 42 42 42 0 0 0 0 0 42 42 42 42 42 42 42 42 42 47 42 42 42 42 42 42 42 42 42 42 42 42 42 42 42 42 42 42 42 42 42 42 42 42
42 42 42 50 46 46 46 46 46 46 47 42 42 42 42 42 42 47 42 42 42 42 34 34 34 34 34 34 34 34 34 34 34 42 42 42 42 42 42 42 42 42 42 42 42 42 42 42 42 0 0 0 0 0 0 0 0 0 0 0 0 0 0 0 0 0 42 42 42 42 42 42 42 42 42 47 42 42 42 42 42 42 42 42 42 42 42 42 42 42 42 42 42 42 42 42 42 42 42 42
42 42 42 42 42 42 42 42 42 42 47 42 42 42 42 42 42 47 42 42 42 42 34 34 34 34 34 34 34 34 34 34 34 34 42 42 43 44 45 42 42 42 42 42 42 42 42 42 42 0 0 0 0 0 0 0 0 0 0 0 0 0 0 0 0 0 42 42 42 42 42 42 42 42 42 47 42 42 42 42 42 42 42 42 42 42 42 42 42 42 42 42 42 42 42 42 42 42 42 42
42 42 42 42 42 42 42 42 42 42 50 46 46 46 46 46 46 46 46 49 42 42 42 42 42 42 42 42 42 42 42 34 34 34 34 34 34 34 34 34 34 34 34 34 34 34 34 34 34 34 34 34 48 49 33 33 33 33 33 33 33 33 42 42 42 42 42 42 42 42 42 42 42 42 42 47 42 42 42 42 42 42 42 42 42 42 42 42 42 42 42 42 42 42 42 42 42 42 42 42
42 42 42 42 42 42 42 42 42 42 42 42 42 42 42 42 42 42 42 50 46 46 46 46 46 46 46 46 46 46 46 46 46 46 46 46 46 46 46 46 46 46 46 46 46 46 46 46 46 46 46 46 51 50 46 46 46 46 46 46 46 46 46 46 46 46 46 46 46 46 46 46 46 46 46 51 42 42 42 42 42 42 42 42 42 42 42 42 42 42 42 42 42 42 42 42 42 42 42 42
_
3
6 : 96 224
2 : 3104 224 3
0 : 2080 480
13 : 352 320 0
0 : 2016 704
-
50
50
46 46 46 46 46 46 46 46 46 46 46 46 46 46 46 46 46 46 46 46 46 46 46 46 46 46 46 46 46 46 46 46 46 46 46 46 46 46 46 46 46 46 46 46 46 46 46 46 46 46
0 0 0 0 0 0 0 0 0 0 0 0 0 0 0 0 0 0 0 0 0 0 0 0 0 0 0 0 0 0 0 0 0 0 0 0 0 0 0 0 0 0 0 0 0 0 0 0 0 42
0 0 0 0 0 0 0 0 0 0 0 0 0 0 0 0 0 0 0 0 0 0 0 0 0 0 0 0 0 0 0 0 0 0 0 0 0 0 0 0 0 0 0 0 0 0 0 0 0 42
0 0 0 0 0 0 0 0 0 0 0 0 0 0 0 0 0 0 0 0 0 0 0 0 0 0 0 0 0 0 0 0 0 0 0 0 0 0 0 0 0 0 0 0 0 0 0 0 0 42
0 0 0 0 0 0 0 0 0 0 0 0 0 0 0 0 0 0 0 0 0 0 0 0 0 0 0 0 0 0 0 0 0 0 0 0 0 0 0 0 0 0 0 0 0 0 0 0 0 42
0 0 0 0 0 0 0 0 0 0 0 0 0 0 0 0 0 0 0 0 0 0 0 0 0 0 0 0 0 0 0 0 0 0 0 0 0 0 0 0 0 0 0 0 0 0 0 0 0 42
46 46 46 46 46 46 46 46 49 0 0 0 42 42 42 42 42 42 42 42 42 42 42 42 42 42 42 0 0 0 0 0 0 0 0 0 0 0 0 0 0 0 0 0 0 0 0 0 0 42
42 42 42 42 42 42 42 42 47 33 33 33 42 42 42 42 42 42 42 42 42 42 42 42 42 42 42 42 0 0 0 0 0 0 0 0 0 0 0 0 0 0 0 0 0 0 0 0 0 42
42 42 42 42 42 42 42 42 47 33 33 33 42 42 42 42 42 42 42 42 42 42 42 42 42 42 42 42 42 0 0 0 0 0 0 0 0 0 0 0 0 0 0 0 0 0 0 0 0 42
42 42 42 42 42 42 42 42 47 33 33 33 42 42 42 42 42 42 42 42 42 42 42 42 42 42 42 42 42 42 0 0 0 0 0 0 0 0 0 0 0 0 0 0 0 0 0 0 0 42
42 42 42 42 42 42 42 42 47 33 33 33 42 42 42 42 42 42 42 42 42 42 42 42 42 42 42 42 42 42 42 0 0 0 0 0 0 0 0 0 0 0 0 0 0 0 0 0 0 42
42 42 42 42 42 42 42 42 47 33 33 33 42 42 42 42 42 42 42 42 42 42 42 42 42 42 42 42 42 42 42 42 42 42 42 0 0 0 0 0 0 0 0 0 0 0 0 0 0 42
42 42 42 42 42 42 42 42 47 33 33 33 42 42 42 42 42 42 42 42 42 42 42 42 42 42 42 42 42 42 42 42 42 42 42 42 0 0 0 0 0 0 0 0 0 0 0 0 0 42
42 42 42 42 42 42 42 42 47 33 33 33 42 42 42 42 42 42 42 42 42 42 42 42 42 42 42 42 42 42 42 42 42 42 42 42 42 0 0 0 0 0 0 0 0 0 0 0 0 42
46 46 46 46 46 46 46 46 51 33 33 33 42 42 42 42 42 42 42 42 42 42 42 42 42 42 42 42 42 42 42 42 42 42 42 42 42 42 0 0 0 0 0 0 0 0 0 0 0 42
42 33 33 33 33 33 33 33 33 33 33 33 42 42 42 42 42 42 42 42 42 42 42 42 42 42 42 42 42 42 42 42 42 42 42 42 42 42 42 0 0 0 0 0 0 0 0 0 0 42
42 33 33 33 33 33 33 33 33 33 33 33 42 42 42 42 42 42 42 42 42 42 42 42 42 42 42 42 42 42 42 42 42 42 42 42 42 42 42 42 0 0 0 0 0 0 0 0 0 42
42 33 33 33 33 33 33 33 33 33 33 33 42 42 42 42 42 42 42 42 42 42 42 42 42 42 42 42 42 42 42 42 42 42 42 42 42 42 42 42 42 0 0 0 0 0 0 0 0 42
42 33 33 33 33 33 33 33 33 33 33 33 42 42 42 42 42 42 42 42 42 42 42 42 42 42 42 42 42 42 42 42 42 42 42 42 42 42 42 42 42 42 0 0 0 0 0 0 0 42
42 33 33 33 33 42 42 42 42 42 42 42 42 42 42 42 42 42 42 42 42 42 42 42 42 42 42 42 42 42 42 42 42 42 42 42 42 42 42 42 42 42 42 0 0 0 0 0 0 42
42 33 33 33 33 42 0 0 0 0 0 0 0 0 0 0 0 0 0 0 42 42 42 42 42 42 42 42 42 42 42 42 42 42 42 42 42 42 42 42 42 42 42 42 0 0 0 0 0 42
42 33 33 33 33 42 0 0 0 0 0 0 0 0 0 0 0 0 0 0 42 42 42 42 42 42 42 42 42 42 42 42 42 42 42 42 42 42 42 42 42 42 42 42 42 0 0 0 0 42
42 33 33 33 33 42 0 0 0 0 0 0 0 0 0 0 0 0 0 0 42 42 42 42 42 42 42 42 42 42 42 42 42 42 42 42 42 42 42 42 42 42 42 42 42 42 0 0 0 42
42 33 33 33 33 42 0 0 0 42 0 0 0 0 0 0 0 42 0 0 42 42 42 42 42 42 42 42 42 42 42 42 42 42 42 42 42 42 42 42 42 42 42 42 42 42 42 0 0 42
42 33 33 33 33 33 33 33 42 42 42 42 42 42 42 42 42 42 0 0 42 0 0 0 0 0 0 0 0 0 0 0 0 0 0 0 0 0 0 0 0 0 0 0 0 0 0 0 0 42
42 33 33 33 33 33 33 33 42 33 33 33 33 33 33 33 33 42 0 0 42 0 0 0 0 0 0 0 0 0 0 0 0 0 0 0 0 0 0 0 0 0 0 0 0 0 0 0 0 42
42 33 33 33 33 33 33 33 42 33 33 33 33 33 33 33 33 42 0 0 42 0 0 0 0 42 0 0 0 0 0 0 0 0 0 0 0 0 0 0 0 0 0 0 0 0 0 0 0 42
42 42 43 44 45 42 42 42 42 33 33 33 33 33 33 33 33 42 0 0 42 0 0 42 42 42 42 42 42 42 42 42 42 42 42 42 42 42 42 42 42 42 42 42 42 42 42 42 42 42
42 33 33 33 33 33 33 33 33 33 33 33 33 33 33 33 33 42 0 0 42 0 0 42 0 0 0 0 0 0 0 0 0 0 0 0 0 0 0 0 0 0 0 0 0 0 0 0 0 42
42 33 33 33 33 33 33 33 33 33 33 33 33 33 33 33 33 42 0 0 42 0 0 42 0 0 0 0 0 0 0 0 0 0 0 0 0 0 0 0 0 0 0 0 0 0 0 0 0 42
42 33 33 33 33 33 33 33 33 33 33 33 33 33 33 33 33 42 0 0 42 0 0 42 0 0 0 0 0 0 0 0 0 0 0 0 0 0 0 0 0 0 0 0 0 0 0 0 0 42
42 33 33 33 33 33 33 33 33 33 33 33 33 33 33 33 33 42 0 0 42 0 0 42 0 0 0 0 0 0 0 0 0 0 0 0 0 0 0 0 0 0 0 0 0 0 0 0 0 42
42 33 33 33 33 33 33 33 33 33 33 33 33 33 33 33 33 42 0 0 42 0 0 42 0 0 0 0 0 0 0 0 0 0 0 0 0 0 0 0 0 0 0 0 0 0 0 0 0 42
42 42 42 42 42 42 42 42 42 42 42 42 42 42 42 42 42 42 0 0 42 0 0 0 0 0 0 0 0 0 0 0 0 0 0 0 0 0 0 0 0 0 0 0 0 0 0 0 0 42
42 0 0 0 0 0 0 0 0 0 0 0 0 0 0 0 0 0 0 0 42 0 0 0 0 0 0 0 0 0 0 0 0 0 0 0 0 0 0 0 0 0 0 0 0 0 0 0 0 42
42 0 0 0 0 0 0 0 0 0 0 0 0 0 0 0 0 0 0 0 42 42 42 42 42 42 42 42 42 42 42 42 42 42 42 42 42 42 42 42 42 42 42 42 42 42 42 0 0 42
42 0 0 0 0 0 0 0 0 0 0 0 0 0 0 0 0 0 0 0 42 42 42 42 42 42 42 42 42 42 42 42 42 42 0 0 0 0 0 0 0 0 0 0 0 0 0 0 0 42
42 0 0 0 0 0 0 0 0 0 0 0 0 0 0 0 52 0 0 0 42 42 42 42 42 42 42 42 42 42 42 42 42 42 0 0 0 0 0 0 0 0 0 0 0 0 0 0 0 42
42 0 0 42 0 0 42 0 0 0 0 42 0 0 0 0 42 42 0 0 42 42 42 42 42 42 42 42 42 42 42 42 42 42 0 0 0 0 0 0 0 0 0 0 0 0 0 0 0 42
42 0 0 42 0 0 0 0 0 0 0 0 0 0 0 0 0 42 33 33 42 42 42 42 42 42 42 42 42 42 42 42 42 42 0 0 42 42 42 42 42 42 42 42 42 42 42 42 42 42
42 0 0 42 0 0 0 0 0 0 0 0 0 0 0 0 0 42 33 33 42 42 42 42 42 42 42 42 42 42 42 42 42 42 0 0 42 42 42 42 42 42 42 42 42 42 42 42 42 42
42 0 0 42 0 0 0 0 0 0 0 0 0 0 0 0 0 42 33 33 42 42 42 42 42 42 42 42 42 42 42 42 42 42 0 0 42 42 42 42 42 42 42 42 42 42 42 42 42 42
42 0 0 42 33 33 33 33 33 33 33 33 33 33 33 33 33 33 33 33 42 42 42 42 42 42 42 42 42 42 42 42 42 42 0 0 42 42 42 42 42 42 42 42 42 42 42 42 42 42
42 0 0 42 33 33 33 33 33 33 33 33 33 33 33 33 33 33 33 33 42 42 42 42 42 42 42 42 42 42 42 42 42 42 0 0 42 42 42 42 42 42 42 42 42 42 42 42 42 42
42 0 0 42 53 53 53 53 53 53 53 53 53 53 53 53 53 53 53 53 42 42 42 42 42 42 42 42 42 42 42 42 42 42 0 0 42 42 42 42 42 42 42 42 42 42 42 42 42 42
42 0 0 42 42 42 42 42 42 42 42 42 42 42 42 42 42 42 42 42 42 42 42 42 42 42 42 42 42 42 42 42 42 42 0 0 42 42 42 42 42 42 42 42 42 42 42 42 42 42
42 0 0 0 0 0 0 0 0 0 0 0 0 0 0 0 0 0 0 0 0 0 0 0 0 0 0 0 0 0 0 0 0 0 0 0 42 42 42 42 42 42 42 42 42 42 42 42 42 42
42 0 0 0 0 0 0 0 0 0 0 0 0 0 0 0 0 0 0 0 0 0 0 0 0 0 0 0 0 0 0 0 0 0 0 0 42 42 42 42 42 42 42 42 42 42 42 42 42 42
42 0 0 0 0 0 0 0 0 0 0 0 0 0 0 0 0 0 0 0 0 0 0 0 0 0 0 0 0 0 0 0 0 0 0 0 42 42 42 42 42 42 42 42 42 42 42 42 42 42
42 42 42 42 42 42 42 42 42 42 42 42 42 42 42 42 42 42 42 42 42 42 42 42 42 42 42 42 42 42 42 42 42 42 42 42 42 42 42 42 42 42 42 42 42 42 42 42 42 42
_
3
6 : 32 32
4 : 736 160
4 : 1056 320
4 : 1344 768
5 : 1344 800
4 : 352 704
4 : 416 704
4 : 480 704
4 : 1024 800
4 : 288 1504
4 : 448 1504
5 : 384 1504
2 : 864 1504 4
4 : 992 1056
4 : 1216 1056
4 : 1376 1056
4 : 1280 1024
4 : 1120 1024
4 : 864 1056
5 : 1376 1184
16 : 1184 1184
16 : 128 1472
17 : 320 1376
-
45
30
42 42 42 42 42 42 42 42 42 0 0 0 0 0 0 0 0 0 0 0 0 0 0 0 0 0 0 0 0 0 0 0 0 0 0 0 0 0 0 0 0 0 0 0 14
42 42 42 42 42 42 42 42 42 0 0 0 0 0 0 0 0 0 0 0 0 0 0 0 0 0 0 0 0 0 0 0 0 0 0 0 0 0 0 0 0 0 0 16 14
42 42 42 42 42 42 42 42 42 0 0 0 0 0 0 0 0 0 0 0 0 0 0 0 0 0 0 0 0 0 0 0 0 0 0 0 0 0 0 0 0 0 0 16 14
42 42 42 42 42 42 42 42 42 0 0 0 0 0 0 0 0 0 0 0 0 0 0 0 0 0 0 0 0 0 0 0 0 0 0 0 0 0 0 0 0 0 0 16 14
42 42 42 42 42 42 42 42 42 0 0 0 0 0 0 0 0 0 0 0 0 0 0 0 0 0 0 0 0 0 0 0 0 0 0 0 0 0 0 0 0 0 0 16 14
42 42 42 42 42 42 42 42 42 0 0 0 0 0 0 0 0 0 0 0 0 0 0 0 0 0 0 0 0 0 0 0 0 0 0 0 0 0 0 0 0 0 0 16 14
42 42 42 42 42 42 42 42 42 0 0 0 0 0 0 0 0 0 0 0 0 0 0 0 0 0 0 0 0 0 0 0 0 0 0 0 0 0 0 0 0 0 0 16 14
42 42 42 42 42 42 42 42 42 0 0 0 0 0 0 0 0 0 0 0 0 0 0 0 0 0 0 0 0 0 0 0 0 0 0 0 0 0 0 0 0 0 0 16 14
42 42 42 42 42 42 42 42 42 0 0 0 0 0 0 0 0 0 0 0 0 0 0 0 0 0 0 0 0 0 0 0 0 0 0 0 0 0 0 0 0 0 0 16 14
42 42 42 42 42 42 42 42 42 0 0 0 0 0 0 0 0 0 0 0 0 0 0 0 0 0 0 0 0 0 0 0 0 0 0 0 0 0 0 0 0 0 0 16 14
42 42 42 42 42 42 42 42 42 0 0 0 0 0 0 0 0 0 0 0 0 0 0 0 0 0 0 0 0 0 0 0 0 0 0 0 0 0 0 0 0 0 0 16 14
42 42 42 42 42 42 42 42 42 0 0 0 0 0 0 0 0 0 0 0 0 0 0 0 0 0 38 0 13 0 41 0 0 0 40 0 0 37 13 0 0 0 0 16 14
42 42 42 42 42 42 42 42 0 0 0 0 0 0 0 0 0 0 0 0 0 0 0 0 0 13 13 13 14 13 13 13 13 13 13 13 13 13 14 13 0 0 0 13 14
42 42 42 42 42 42 42 0 0 0 0 0 0 0 0 0 0 0 0 0 0 0 0 0 13 14 14 14 14 14 14 14 14 14 14 14 14 14 14 14 0 0 0 14 14
42 42 42 42 42 42 0 0 0 0 0 0 0 0 0 0 0 0 0 0 0 0 0 13 14 14 14 14 14 14 0 0 0 0 0 0 0 0 0 0 0 0 0 14 14
42 42 42 42 42 0 0 0 0 0 0 0 0 0 0 0 0 0 0 0 0 0 13 14 14 14 14 14 14 14 0 0 0 0 0 0 0 0 0 0 0 0 0 14 14
42 42 42 42 0 0 0 0 0 0 0 0 0 0 0 0 0 0 0 0 0 13 14 14 14 14 14 14 14 14 0 0 0 0 0 0 0 0 0 0 0 0 0 14 14
42 42 42 0 0 0 0 0 0 0 0 0 0 0 0 0 0 0 0 0 13 14 14 14 14 14 14 14 14 14 0 0 14 14 14 14 14 14 14 14 14 14 14 14 14
42 42 0 0 0 0 0 0 0 0 0 0 0 0 0 0 0 0 0 13 14 14 14 14 14 14 14 14 14 14 0 0 14 14 14 14 14 14 14 14 14 14 14 14 14
42 0 0 0 0 0 0 0 0 0 0 0 0 0 0 0 0 0 13 14 14 14 14 14 14 14 14 14 14 14 0 0 14 14 14 14 14 14 14 14 14 14 14 14 14
0 0 0 0 0 0 0 0 0 0 0 0 0 0 0 38 0 13 14 14 14 14 14 14 14 14 14 14 14 14 0 0 14 14 14 14 14 14 14 14 14 14 14 14 14
0 0 0 0 0 42 42 42 42 42 42 42 42 42 13 13 13 14 14 14 14 14 14 14 14 14 14 14 14 14 0 0 14 14 14 14 14 14 14 14 14 14 14 14 14
0 0 0 0 42 42 42 42 42 42 42 42 42 42 14 14 14 14 14 14 14 14 14 14 14 14 14 14 14 14 0 0 14 14 14 14 14 14 14 14 14 14 14 14 14
0 0 0 42 42 42 33 33 33 33 33 42 42 42 14 14 14 14 14 14 14 14 14 14 14 14 14 14 14 14 0 0 14 14 14 14 14 14 14 14 14 14 14 14 14
0 0 42 42 42 42 33 33 33 33 33 42 42 42 14 14 14 14 14 14 14 14 14 14 14 14 14 14 14 14 0 0 14 14 14 14 14 14 14 14 14 14 14 14 14
0 42 42 42 48 46 46 46 49 33 33 42 42 42 14 14 14 14 14 14 14 14 14 14 14 14 14 14 14 14 33 33 14 14 14 14 14 14 14 14 14 14 14 14 14
42 42 42 48 51 42 42 42 47 33 33 42 42 42 14 14 14 14 14 14 14 14 14 14 14 14 14 14 14 14 33 33 14 14 14 14 14 14 14 14 14 14 14 14 14
42 42 48 51 42 42 42 42 47 33 33 33 33 33 33 33 33 33 33 33 33 33 33 33 33 33 33 33 33 33 33 33 14 14 14 14 14 14 14 14 14 14 14 14 14
42 48 51 42 42 42 42 42 47 33 33 33 33 33 33 33 33 33 33 33 33 33 33 33 33 33 33 33 33 33 33 33 14 14 14 14 14 14 14 14 14 14 14 14 14
46 51 42 42 42 42 42 42 47 42 42 42 42 42 14 14 14 14 14 14 14 14 14 14 14 14 14 14 14 14 14 14 14 14 14 14 14 14 14 14 14 14 14 14 14
_
1
4 : 1024 288
4 : 1088 288
2 : 224 736 5
12 : 896 320
6 : 32 672
-
10
25
42 42 42 42 42 42 42 42 42 42
42 33 33 33 33 33 33 33 33 42
42 33 33 33 33 33 33 33 33 42
42 33 33 33 33 33 33 33 33 42
42 33 33 33 33 33 33 33 33 42
42 33 33 33 33 33 33 33 33 42
42 33 33 33 33 33 33 33 33 42
42 33 33 33 33 33 33 33 33 42
42 33 33 33 33 33 33 33 33 42
42 33 33 33 33 33 33 33 33 42
42 33 33 33 33 33 33 33 33 42
42 33 33 33 33 33 33 33 33 42
42 33 33 33 33 33 33 33 33 42
42 33 33 33 33 33 33 33 33 42
42 33 33 33 33 33 33 33 33 42
42 33 33 33 33 33 33 33 33 42
42 33 33 33 33 33 33 33 33 42
42 33 33 33 33 33 33 33 33 42
42 33 33 33 33 33 33 33 33 42
42 33 33 33 33 33 33 33 33 42
42 33 33 33 33 33 33 33 33 42
42 33 33 33 33 33 33 33 33 42
42 33 33 33 33 33 33 33 33 42
42 33 33 33 33 33 33 33 33 42
42 42 42 42 42 42 42 42 42 42
_
3
6 : 32 32
2 : 160 704 6
17 : 128 480
17 : 224 288
17 : 64 352
17 : 224 544
17 : 128 640
17 : 32 608
17 : 224 672
-
30
20
14 15 0 0 0 0 0 0 0 0 0 0 0 0 0 0 0 0 0 0 0 0 0 0 0 0 0 0 16 14
14 15 0 0 0 0 0 0 0 0 0 0 0 0 0 0 0 0 0 0 0 0 0 0 0 0 0 0 16 14
14 15 0 0 0 0 0 0 0 0 0 0 0 0 0 0 0 0 0 0 0 0 0 0 0 0 0 0 16 14
14 15 0 0 0 0 0 0 0 0 0 0 0 0 0 0 0 0 0 0 0 0 0 0 0 0 0 0 16 14
14 15 0 0 0 0 0 0 0 0 0 0 0 0 0 0 0 0 0 0 0 0 0 0 0 0 0 0 16 14
14 15 0 0 0 0 0 0 0 0 0 0 0 0 0 0 0 0 0 0 0 0 0 0 0 0 0 0 16 14
14 13 13 13 13 13 13 13 13 13 13 13 13 13 13 13 13 0 0 13 13 13 13 13 13 13 13 13 13 14
14 14 14 14 14 14 14 14 14 14 14 14 14 14 14 14 14 0 0 14 14 14 14 14 14 14 14 14 14 14
42 0 0 0 0 0 0 0 0 0 0 0 0 0 0 0 0 0 0 0 0 0 0 0 0 0 0 0 0 42
42 0 0 0 0 0 0 0 0 0 0 0 0 0 0 0 0 0 0 0 0 0 0 0 0 0 0 0 0 42
42 0 0 0 0 0 0 0 0 0 0 0 0 0 0 0 42 42 42 0 0 0 0 0 0 0 0 0 0 42
42 0 0 0 0 0 0 0 0 0 0 0 0 0 0 0 0 0 0 0 0 0 0 0 0 0 0 0 0 42
42 0 0 0 0 0 0 0 0 0 0 0 0 0 0 0 0 0 0 0 0 0 0 0 0 0 0 0 0 42
42 0 0 0 0 0 0 0 0 0 0 0 0 0 0 0 0 0 0 0 0 0 0 0 0 0 0 0 0 42
42 0 0 0 0 0 0 0 0 0 0 0 0 0 0 0 0 0 0 0 0 0 0 0 0 0 0 0 0 42
42 0 0 0 0 0 0 0 0 0 0 0 0 42 42 42 0 0 0 0 0 0 0 0 0 0 0 0 0 42
42 0 0 0 0 0 0 0 0 0 0 0 0 0 0 0 0 0 0 0 0 0 0 0 0 0 0 0 0 42
42 0 0 0 0 0 0 0 0 0 0 0 0 0 0 0 0 0 0 0 0 0 0 0 0 0 0 0 0 42
42 0 0 0 0 0 0 0 0 0 0 0 0 0 0 0 0 0 0 0 0 52 0 0 0 0 0 0 0 42
42 42 42 42 42 42 42 42 42 42 42 42 42 42 42 42 42 42 42 42 42 42 33 33 33 33 33 33 33 42
_
3
6 : 32 480
1 : 480 352
1 : 576 192
1 : 384 480
11 : 768 64
-
