30
20
14 0 0 0 0 0 0 0 0 0 0 0 0 0 0 0 0 0 0 0 0 0 0 0 0 0 0 0 16 14
14 0 0 0 0 0 0 0 0 0 0 0 0 0 0 0 0 0 0 0 0 0 0 0 0 0 0 0 16 14
14 0 0 0 0 0 0 0 0 0 0 0 0 0 0 0 0 0 0 0 0 0 0 0 0 0 0 0 16 14
14 0 0 0 0 0 0 0 0 0 0 0 0 0 0 0 0 0 0 0 0 0 0 0 0 0 0 0 16 14
14 0 0 0 0 0 0 0 0 0 0 0 0 0 0 0 0 0 0 0 0 0 0 0 0 0 0 0 16 14
14 0 0 0 0 0 0 0 0 0 0 0 0 0 0 0 0 0 0 0 0 0 0 0 0 0 0 0 16 14
14 0 0 0 0 0 0 0 0 0 0 0 0 0 0 0 0 0 0 0 0 0 0 0 0 0 0 0 16 14
14 13 13 13 13 13 13 13 13 13 13 13 13 13 13 13 13 13 13 13 13 13 13 13 13 13 13 0 16 14
14 0 0 0 0 0 0 0 0 0 0 0 0 0 0 0 0 0 0 0 0 0 0 0 0 0 0 0 16 14
14 0 0 0 0 0 0 0 0 0 0 0 0 0 0 0 0 0 0 0 0 0 0 0 0 0 0 0 16 14
14 0 0 0 0 0 0 0 0 0 0 0 0 0 0 0 0 0 0 0 0 0 0 0 0 0 0 0 16 14
14 0 0 0 0 0 0 0 0 0 0 0 0 0 0 0 0 0 0 0 0 0 0 0 0 0 0 0 16 14
14 0 0 0 0 0 0 0 0 0 0 0 0 0 0 0 0 0 0 0 0 0 0 0 0 0 0 0 16 14
14 0 0 0 0 0 0 0 0 0 0 0 0 0 0 0 0 0 0 0 0 0 0 0 0 0 0 0 16 14
14 0 0 13 13 13 13 13 13 13 13 13 13 13 13 13 13 13 13 13 13 13 13 13 13 13 13 13 13 14
14 0 0 0 0 0 0 0 0 0 0 0 0 0 0 0 0 0 0 0 0 0 0 0 0 0 0 0 16 14
14 0 0 0 0 0 0 0 0 0 0 0 0 0 0 0 0 0 0 0 0 0 0 0 0 0 0 0 16 14
14 0 0 0 0 0 0 0 0 0 0 0 0 0 0 0 0 0 0 0 0 0 0 0 0 0 0 0 16 14
14 0 0 0 0 0 0 0 0 0 0 0 0 0 0 0 0 0 0 0 0 0 0 0 0 0 0 0 16 14
14 13 13 13 13 13 13 13 13 13 13 13 13 13 13 13 13 13 13 13 13 13 13 13 13 13 13 13 13 14
_
0
6 : 32 160
5 : 160 384
5 : 352 384
5 : 640 384
5 : 480 320
5 : 480 384
5 : 256 320
16 : 320 544
16 : 512 544
2 : 832 544 1
-
15
80
14 14 14 14 14 14 14 14 14 14 14 14 14 14 14
14 0 0 0 0 0 0 0 0 0 0 0 0 0 14
14 0 0 0 0 0 0 0 0 0 0 0 0 0 14
14 0 0 0 0 0 0 0 0 0 0 0 0 0 14
14 0 0 0 0 0 0 0 0 0 0 0 0 0 14
14 0 0 0 0 0 0 0 0 0 0 0 0 0 14
14 14 14 14 14 14 14 0 0 0 14 14 14 14 14
14 14 14 14 14 0 0 0 0 0 14 33 33 33 14
14 14 14 14 14 0 0 0 0 0 14 33 33 33 14
14 14 14 14 14 0 0 0 0 0 14 33 33 33 14
14 14 14 14 14 0 0 0 0 0 14 33 33 33 14
14 14 14 14 14 0 0 0 0 0 14 33 33 33 14
14 14 14 14 14 0 0 0 0 0 14 33 33 33 14
14 14 14 14 14 0 0 0 0 0 14 33 33 33 14
14 14 14 14 14 0 0 0 0 0 14 14 14 14 14
14 14 14 14 14 0 0 0 0 0 14 0 0 0 14
14 14 14 14 14 0 0 0 0 0 14 0 0 0 14
14 14 14 14 14 0 0 0 0 0 14 0 0 0 14
14 14 14 14 14 0 0 0 0 0 14 0 0 0 14
14 14 14 14 14 0 0 0 0 0 14 0 0 0 14
14 14 14 14 14 0 0 0 0 0 14 0 0 0 14
14 14 14 14 14 0 0 0 0 0 14 14 14 14 14
14 14 14 14 14 0 0 0 0 0 14 53 53 53 14
14 14 14 14 14 0 0 0 0 0 14 53 53 53 14
14 14 14 14 14 0 0 0 0 0 14 53 53 53 14
14 14 14 14 14 0 0 0 0 0 14 53 53 53 14
14 14 14 14 14 0 0 0 0 0 14 53 53 53 14
14 14 14 14 14 0 0 0 0 0 14 53 53 53 14
14 14 14 14 14 0 0 0 0 0 14 53 53 53 14
14 14 14 14 14 0 0 0 0 0 14 53 53 53 14
14 14 14 14 14 0 0 0 0 0 14 53 53 53 14
14 14 14 14 14 0 0 0 0 0 14 53 53 53 14
14 14 14 14 14 0 0 0 0 0 14 14 14 14 14
14 14 14 14 14 0 0 0 0 0 14 0 0 0 14
14 14 14 14 14 0 0 0 0 0 14 0 0 0 14
14 14 14 14 14 0 0 0 0 0 14 0 0 0 14
14 14 14 14 14 0 0 0 0 0 14 0 0 0 14
14 14 14 14 14 0 0 0 0 0 14 0 0 0 14
14 14 14 14 14 0 0 0 0 0 14 0 0 0 14
14 14 14 14 14 0 0 0 0 0 14 0 0 0 14
14 14 14 14 14 0 0 0 0 0 14 0 0 0 14
14 14 14 14 14 0 0 0 0 0 14 14 14 14 14
14 14 14 14 14 0 0 0 0 0 14 33 33 33 14
14 14 14 14 14 0 0 0 0 0 14 33 33 33 14
14 14 14 14 14 0 0 0 0 0 14 33 33 33 14
14 14 14 14 14 0 0 0 0 0 14 33 33 33 14
14 14 14 14 14 0 0 0 0 0 14 33 33 33 14
14 14 14 14 14 0 0 0 0 0 14 33 33 33 14
14 14 14 14 14 0 0 0 0 0 14 33 33 33 14
14 14 14 14 14 0 0 0 0 0 14 14 14 14 14
14 14 14 14 14 0 0 0 0 0 14 0 0 0 14
14 14 14 14 14 0 0 0 0 0 14 0 0 0 14
14 14 14 14 14 0 0 0 0 0 14 0 0 0 14
14 14 14 14 14 0 0 0 0 0 14 0 0 0 14
14 14 14 14 14 0 0 0 0 0 14 0 0 0 14
14 14 14 14 14 0 0 0 0 0 14 0 0 0 14
14 14 14 14 14 0 0 0 0 0 14 0 0 0 14
14 14 14 14 14 0 0 0 0 0 14 14 14 14 14
14 14 14 14 14 0 0 0 0 0 14 0 0 0 14
14 14 14 14 14 0 0 0 0 0 14 0 0 0 14
14 14 14 14 14 0 0 0 0 0 14 0 0 0 14
14 14 14 14 14 0 0 0 0 0 14 0 0 0 14
14 14 14 14 14 0 0 0 0 0 14 0 0 0 14
14 14 14 14 14 0 0 0 0 0 14 0 0 0 14
14 14 14 14 14 0 0 0 0 0 14 0 0 0 14
14 14 14 14 14 0 0 0 0 0 14 0 0 0 14
14 14 14 14 14 0 0 0 0 0 14 0 0 0 14
14 14 14 14 14 0 0 0 0 0 14 14 14 14 14
14 14 14 14 14 0 0 0 0 0 14 0 0 0 14
14 14 14 14 14 0 0 0 0 0 14 0 0 0 14
14 14 14 14 14 0 0 0 0 0 14 0 0 0 14
14 14 14 14 14 0 0 0 0 0 14 0 0 0 14
14 14 14 14 14 0 0 0 0 0 14 0 0 0 14
14 14 14 14 14 0 0 0 0 0 14 0 0 0 14
14 14 14 14 14 0 0 0 0 0 14 0 0 0 14
14 14 14 14 14 0 0 0 0 0 14 0 0 0 14
14 14 14 14 14 0 0 0 0 0 14 0 0 0 14
14 14 14 14 14 0 0 0 0 0 14 0 0 0 14
14 14 14 14 14 0 0 0 0 0 14 0 0 0 14
14 14 14 14 14 13 13 13 13 13 14 13 13 13 14
_
0
3 : 256 2464 262.0 118.0
4 : 352 2400
4 : 416 2400
5 : 384 2048
5 : 384 1760
17 : 384 1344
17 : 384 1440
17 : 384 1536
4 : 352 608
16 : 384 544
17 : 352 256
17 : 416 256
17 : 384 320
17 : 416 384
17 : 352 384
12 : 32 128
12 : 64 128
12 : 96 128
12 : 128 128
12 : 160 128
2 : 384 128 2
5 : 384 608
16 : 384 1152
16 : 352 1152
6 : 192 2432
-
30
20
14 14 14 14 14 14 14 14 14 14 14 14 14 14 14 14 14 14 14 14 14 14 14 14 14 14 14 14 14 14
14 15 0 0 0 0 0 0 0 0 0 0 0 0 0 0 0 0 0 0 0 0 0 14 14 14 14 14 14 14
14 15 0 0 0 0 0 0 0 0 0 0 0 0 0 0 0 0 0 0 0 0 0 14 14 14 14 14 14 14
14 15 0 0 0 0 0 0 0 0 0 0 0 0 0 0 0 0 0 0 0 0 0 14 14 14 14 14 14 14
14 15 0 0 0 0 0 0 0 0 0 0 0 0 0 0 0 0 0 0 0 0 0 14 14 14 14 14 14 14
14 15 0 0 0 0 0 0 0 0 0 0 0 0 0 0 0 0 0 0 0 0 0 14 14 14 14 14 14 14
14 15 0 0 0 0 0 0 0 0 0 0 0 0 0 0 0 0 0 0 0 0 0 14 14 14 14 14 14 14
14 15 0 0 0 0 0 0 0 0 0 0 0 0 0 0 0 0 0 0 0 0 0 14 14 14 14 14 14 14
14 15 0 0 0 0 0 0 0 0 0 0 0 0 0 0 0 0 0 0 0 0 0 14 14 14 14 14 14 14
14 15 0 0 0 0 0 0 0 0 0 0 0 0 0 0 0 0 0 0 0 0 0 14 14 14 14 14 14 14
14 15 0 0 0 0 0 0 0 0 0 0 0 0 0 0 0 0 0 0 0 0 0 14 14 14 14 14 14 14
14 15 0 0 0 0 0 0 0 0 0 0 0 0 0 0 0 0 0 0 0 0 0 14 14 14 14 14 14 14
14 15 0 0 0 0 0 0 0 0 0 0 0 0 0 0 0 0 0 0 0 0 0 14 14 14 14 14 14 14
14 15 0 0 0 0 0 0 0 0 0 0 0 0 0 0 0 0 0 0 0 0 0 14 14 14 14 14 14 14
14 15 0 0 0 0 0 0 0 0 0 0 0 0 0 0 0 0 0 0 0 0 0 14 14 14 14 14 14 14
14 15 0 0 0 0 0 0 0 0 0 0 0 0 0 0 0 0 0 0 0 0 0 14 14 14 14 14 14 14
14 15 0 0 0 0 0 0 0 0 0 0 0 0 0 0 0 0 0 0 0 0 0 0 0 0 0 0 0 14
14 15 0 0 0 0 0 0 0 0 0 0 0 0 13 0 0 0 0 0 0 0 0 0 0 0 0 0 0 14
14 15 0 0 0 13 0 0 0 0 0 0 0 0 14 0 0 0 0 0 0 0 0 0 0 0 0 0 0 14
14 13 13 13 13 14 13 13 13 13 13 13 13 13 14 13 13 13 13 13 13 13 13 13 13 13 13 13 13 14
_
5
14 : 736 512 0
18 : 608 480 0
2 : 864 544 3
6 : 64 512
-
100
10
14 15 0 0 0 0 0 0 0 0 0 0 0 0 0 0 0 0 0 0 0 0 0 0 0 0 0 0 0 0 0 0 0 0 0 0 0 0 0 0 0 0 0 0 0 0 0 0 0 0 0 0 0 0 0 0 0 0 0 0 0 0 0 0 0 0 0 0 0 0 0 0 0 0 0 0 0 0 0 0 0 0 0 0 0 0 0 0 0 0 0 0 0 0 0 0 0 0 16 14
14 15 0 0 0 0 0 0 0 0 0 0 0 0 0 0 0 0 0 0 0 0 0 0 0 0 0 0 0 0 0 0 0 0 0 0 0 0 0 0 0 0 0 0 0 0 0 0 0 0 0 0 0 0 0 0 0 0 0 0 0 0 0 0 0 0 0 0 0 0 0 0 0 0 0 0 0 0 0 0 0 0 0 0 0 0 0 0 0 0 0 0 0 0 0 0 0 0 16 14
14 15 0 0 0 0 0 0 0 0 0 0 0 0 0 0 0 0 0 0 0 0 0 0 0 0 0 0 0 0 0 0 0 0 0 0 0 0 0 0 0 0 0 0 0 0 0 0 0 0 0 0 0 0 0 0 0 0 0 0 0 0 0 0 0 0 0 0 0 0 0 0 0 0 0 0 0 0 0 0 0 0 0 0 0 0 0 0 0 0 0 0 0 0 0 0 0 0 16 14
14 15 0 0 0 0 0 0 0 0 0 0 0 0 0 0 0 0 0 0 0 0 0 0 0 0 0 0 0 0 0 0 0 0 0 0 0 0 0 0 0 0 0 0 0 0 0 0 0 0 0 0 0 0 0 0 0 0 0 0 0 0 0 0 0 0 0 0 0 0 0 0 0 0 0 0 0 0 0 0 0 0 0 0 0 0 0 0 0 0 0 0 0 0 0 0 0 0 16 14
14 15 0 0 0 0 0 0 0 0 0 0 0 0 0 0 0 0 0 0 0 0 0 0 0 0 0 0 0 0 0 0 0 0 0 0 0 0 0 0 0 0 0 0 0 0 0 0 0 0 0 0 0 0 0 0 0 0 0 0 0 0 0 0 0 0 0 0 0 0 0 0 0 0 0 0 0 0 0 0 0 0 0 0 0 0 0 0 0 0 0 0 0 0 0 0 0 0 16 14
14 15 0 0 0 0 0 0 0 0 0 0 0 0 0 0 0 0 0 0 0 0 0 0 0 0 0 0 0 0 0 0 0 0 0 0 0 0 0 0 0 0 0 0 0 0 0 0 0 0 0 0 0 0 0 0 0 0 0 0 0 0 0 0 0 0 0 0 0 0 0 0 0 0 0 0 0 0 0 0 0 0 0 0 0 0 0 0 0 0 0 0 0 0 0 0 0 0 16 14
14 15 0 0 0 0 0 0 0 0 0 0 0 0 0 0 0 0 0 0 0 0 0 0 0 0 0 0 0 0 0 0 0 0 0 0 0 0 0 0 0 0 0 0 0 0 0 0 0 0 0 0 0 0 0 0 0 0 0 0 0 0 0 0 0 0 0 0 0 0 0 0 0 0 0 0 0 0 0 0 0 0 0 0 0 0 0 0 0 0 0 0 0 0 0 0 0 0 16 14
14 15 0 0 0 0 0 0 0 0 0 0 0 0 0 0 0 0 0 0 0 0 0 0 0 0 0 0 0 0 0 0 0 0 0 0 0 0 0 0 0 0 0 0 0 0 0 0 0 0 0 0 0 0 0 0 0 0 0 0 0 0 0 0 0 0 0 0 0 0 0 0 0 0 0 0 0 0 0 0 0 0 0 0 0 0 0 0 0 0 0 0 0 0 0 0 0 0 16 14
14 15 0 0 0 0 0 13 13 13 0 0 0 0 0 0 0 0 0 0 0 0 0 0 0 0 0 0 0 0 0 0 0 0 0 0 0 0 0 0 0 0 0 0 0 0 0 0 0 0 0 0 0 0 0 0 0 0 0 0 0 0 0 0 0 0 0 0 0 0 0 0 0 0 0 0 0 0 0 0 0 0 0 0 0 0 0 0 0 0 0 0 0 0 0 0 0 0 16 14
14 13 13 13 13 13 13 14 14 14 53 53 53 53 53 53 53 53 53 53 53 53 53 53 53 53 53 53 53 53 53 53 53 53 53 53 53 53 53 53 53 53 53 53 53 53 53 53 53 53 53 53 53 53 53 53 53 53 53 53 53 53 53 53 53 53 53 53 53 53 53 53 53 53 53 53 53 53 53 53 53 53 53 53 53 53 53 53 53 53 53 13 13 13 13 13 13 13 13 14
_
0
6 : 128 224
3 : 270 192 3111.0 166.0
11 : 3008 128
-
